%%%%%%%%%%%%%%%%%%%%
%o...%........%...o%
%.%%.%.%%..%%.%.%%.%
%.%.....%..%.....%.%
%.%.%%.%%  %%.%%.%.%
%...... 1   %.%....%
%.%....%%%%%%.%..%.%
%.%....%  oo%.%..%.%
%.%....% %%%%.%..%.%
%.%1..........%..%.%
%.%%.%.%%%%%%.%.%%.%
%o...%...P....%...o%
%%%%%%%%%%%%%%%%%%%%
