%%%%%%%%%%%%%%%%%%%%%%%%%
%.. P  ....      ....   %
%..  ...  ...  ...  ... %
%..  ..   ...  ..   ... %
%..    2...       ... 2 %
%..   ...       ...     %
%..  ........  ........ %
%..  ........  ........o%
%%%%%%%%%%%%%%%%%%%%%%%%%
