%%%%%%%%%%
%rrrrrrrr%
%rrrrrrrr%
%rrrrrrrr%
%rrrGrrrr%
%rrrrrrrr%
%rrrrrrrr%
%rrrrrrrr%
%rrrrPrrr%
%%%%%%%%%%