%%%%%%%%%%
%   .    %
%        %
%.       %
% . G    %
%.   . . %
%. . .   %
% ..  .. %
%    P   %
%%%%%%%%%%