%%%%%%%%%%
%      . %
%.   .   %
%. ..    %
%.       %
%      . %
%  .     %
%        %
%  ..P.  %
%%%%%%%%%%