%%%%%%%%%%
% .    . %
%.G.     %
% .   .  %
%. .     %
%     .  %
%  .   . %
%     .  %
%P   .   %
%%%%%%%%%%