%%%%%%%%%%
%   G    %
%    .   %
%    . ..%
%   G.   %
%.     ..%
%   .    %
%..      %
%  . P   %
%%%%%%%%%%