%%%%%%%%%%
%.  .  . %
%  .  .  %
%.. .. ..%
%        %
% .   .  %
%       .%
%. ..    %
%P . ..  %
%%%%%%%%%%